team,win,lose,pointsScored,pointsAllowed,fg,fga,fg2,fg2a,fg3,fg3a,ft,fta,orb,drb,ast,stl,blk,tov,pf,opp_fg,opp_fga,opp_fg2,opp_fg2a,opp_fg3,opp_fg3a,opp_ft,opp_ft,opp_orb,opp_drb,opp_ast,opp_stl,opp_blk,opp_tov,opp_pf
virginia,31,2,67.5,53.4,825,1788,582,1165,243,623,336,443,277,800,453,224,123,283,464,621,1655,418,985,203,670,317,317,277,738,292,128,87,420,497
maryland-baltimore-county,24,10,73.9,69.5,886,1993,540,1099,346,894,395,609,338,846,525,256,85,411,562,842,1912,565,1127,277,785,401,401,329,903,449,217,93,504,645
creighton,21,11,84.3,74.2,985,1982,651,1093,334,889,393,526,232,929,576,181,85,358,480,884,2043,632,1277,252,766,355,355,298,827,448,194,94,376,518
kansas-state,22,11,72.4,67.9,854,1809,625,1144,229,665,451,608,269,741,473,256,99,379,607,762,1776,528,1071,234,705,482,482,352,760,418,185,81,473,599
kentucky,24,10,76.7,70.3,920,1958,735,1445,185,513,584,838,411,904,455,191,166,442,642,836,2060,576,1191,260,869,458,458,410,743,440,194,129,407,688
davidson,21,11,76.4,67.6,875,1813,533,939,342,874,354,444,218,832,539,153,63,306,481,776,1776,510,1020,266,756,344,344,253,753,406,152,80,342,506
arizona,27,7,80.9,71.2,980,1940,745,1316,235,624,555,729,341,905,518,168,155,417,592,856,1984,610,1285,246,699,462,462,302,685,430,209,90,396,671
buffalo,26,8,84.8,75.9,1045,2205,716,1318,329,887,464,666,407,919,576,217,143,426,719,871,2051,641,1356,230,695,607,607,366,874,386,197,128,474,626
miami-fl,22,9,74.2,68.0,850,1832,607,1163,243,669,354,534,309,771,413,203,123,351,505,768,1786,561,1152,207,634,364,364,309,751,404,176,105,402,512
loyola-il,28,5,72.4,62.2,869,1714,623,1096,246,618,406,561,209,858,519,219,82,404,456,755,1831,534,1160,221,671,323,323,294,719,388,210,101,434,552
tennessee,25,8,74.2,66.4,833,1897,574,1222,259,675,524,693,385,809,522,208,148,403,646,743,1813,533,1155,210,658,495,495,371,764,357,186,109,461,644
wright-state,25,9,72.1,65.7,854,1959,621,1277,233,682,512,714,346,889,451,226,75,446,541,789,1905,526,1148,263,757,393,393,290,844,407,198,96,519,685
nevada,27,7,83.1,72.9,963,2056,633,1226,330,830,569,762,320,905,559,213,139,338,586,887,2063,633,1249,254,814,450,450,366,863,440,154,97,442,665
texas,19,14,71.7,68.2,851,1943,617,1201,234,742,431,645,349,826,381,205,163,390,531,829,1965,603,1280,226,685,367,367,348,834,402,179,94,418,589
cincinnati,30,4,74.5,57.1,893,1972,645,1277,248,695,498,725,444,879,543,248,188,389,535,688,1860,471,1158,217,702,350,350,349,719,346,168,101,503,625
georgia-state,24,10,75.3,67.3,916,1980,601,1168,315,812,414,612,298,858,452,250,155,386,624,747,1901,449,1030,298,871,496,496,398,852,443,167,114,493,567
xavier,28,5,84.3,74.5,953,1942,695,1243,258,699,617,781,322,945,549,193,97,410,558,894,2072,609,1218,285,854,385,385,280,752,473,218,119,375,687
texas-southern,16,19,77.3,78.8,899,2046,627,1290,272,756,634,879,361,909,426,197,141,442,610,1013,2256,744,1516,269,740,462,462,434,905,550,185,135,413,735
missouri,20,12,73.3,68.1,778,1716,480,941,298,775,491,667,327,862,435,165,136,453,573,774,1901,550,1210,224,691,407,407,339,705,358,208,111,354,630
florida-state,20,11,81.8,74.5,906,1912,658,1206,248,706,473,691,363,816,473,208,160,403,566,809,1923,546,1200,263,723,428,428,351,732,398,182,92,437,583
ohio-state,24,8,75.8,66.7,894,1842,678,1230,216,612,422,581,309,865,472,193,127,378,556,756,1823,506,1101,250,722,372,372,284,717,381,165,83,393,561
south-dakota-state,28,6,84.9,74.1,979,2084,618,1188,361,896,566,745,302,1019,459,169,78,340,547,928,2163,649,1328,279,835,383,383,291,905,395,162,89,362,655
gonzaga,30,4,84.5,67.1,1049,2085,740,1259,309,826,466,645,376,981,535,219,126,384,579,805,1987,553,1278,252,709,420,420,289,762,373,172,89,417,613
north-carolina-greensboro,27,7,73.5,62.4,896,2006,568,1092,328,914,378,539,404,858,480,263,131,468,628,704,1737,480,1031,224,706,489,489,257,774,341,240,77,518,565
houston,26,7,77.4,64.9,910,1953,625,1216,285,737,450,628,391,880,492,212,103,401,693,703,1773,484,1105,219,668,517,517,304,740,361,167,82,438,607
san-diego-state,22,10,77.5,67.9,882,1913,647,1220,235,693,481,667,355,851,477,202,102,382,545,773,1849,527,1095,246,754,381,381,292,745,435,198,108,436,611
michigan,28,7,74.5,63.5,943,2003,623,1135,320,868,400,607,300,867,518,219,111,320,545,813,1891,619,1317,194,574,404,404,287,853,365,142,110,450,619
montana,26,7,78.1,68.7,926,1965,743,1431,183,534,543,769,392,833,421,256,112,410,695,763,1778,559,1210,204,568,538,538,290,776,332,164,126,508,660
texas-am,20,12,75.0,69.8,887,1942,676,1297,211,645,415,622,402,921,495,180,188,434,536,800,1983,558,1237,242,746,392,392,364,768,456,204,135,360,558
providence,21,13,73.7,72.7,872,1975,655,1324,217,651,545,775,359,862,468,233,128,424,601,887,2002,653,1272,234,730,463,463,343,880,431,225,119,455,661
north-carolina,25,10,82.0,73.1,1048,2279,758,1483,290,796,483,652,492,995,637,197,147,422,550,918,2173,578,1285,340,888,383,383,349,789,510,214,165,406,626
lipscomb,23,9,82.6,77.5,901,1976,641,1191,260,785,580,811,340,907,503,207,100,480,638,867,1942,627,1234,240,708,506,506,282,840,425,225,142,493,695
villanova,30,4,87.1,70.9,1055,2092,667,1117,388,975,462,599,319,889,567,227,135,352,539,889,2047,651,1321,238,726,394,394,325,785,476,155,91,445,585
radford,23,12,67.5,64.3,830,1941,561,1172,269,769,432,598,400,813,432,220,102,428,579,788,1845,541,1127,247,718,426,426,311,790,393,191,115,456,584
alabama,19,15,72.4,70.0,860,1877,643,1209,217,668,523,778,341,890,426,218,186,481,645,822,1992,586,1252,236,740,499,499,394,826,395,224,128,449,676
west-virginia,24,10,79.6,69.0,944,2176,645,1329,299,847,520,679,476,813,512,273,179,385,725,765,1801,509,1116,256,685,560,560,348,824,416,186,134,561,636
murray-state,26,5,78.9,65.5,849,1752,585,1056,264,696,485,664,327,823,459,211,98,368,537,729,1779,534,1141,195,638,379,379,303,669,304,164,101,394,556
wichita-state,25,7,83.0,71.3,930,1944,638,1186,292,758,504,683,389,902,593,150,126,370,562,781,1862,508,1109,273,753,448,448,266,709,345,188,107,370,643
marshall,24,10,84.3,78.8,992,2115,651,1151,341,964,540,704,274,958,585,233,198,449,586,999,2267,754,1574,245,693,437,437,430,949,503,226,88,485,635
florida,20,12,76.1,69.4,841,1937,549,1159,292,778,460,640,345,779,415,219,151,315,552,787,1835,567,1219,220,616,428,428,346,848,367,141,97,442,574
st-bonaventure,26,7,77.5,70.6,867,1910,615,1268,252,642,572,760,338,831,462,232,115,373,655,780,1852,524,1055,256,797,514,514,344,805,444,170,129,479,642
texas-tech,24,9,75.2,64.7,863,1859,631,1225,232,634,525,749,361,821,447,245,134,412,599,718,1780,491,1088,227,692,472,472,324,724,331,194,121,499,688
stephen-f-austin,28,6,81.1,68.1,982,2012,745,1375,237,637,558,791,395,822,490,347,103,527,740,743,1738,501,1067,242,671,588,588,316,763,435,255,120,678,695
arkansas,23,11,81.1,75.5,985,2063,720,1400,265,663,522,770,346,837,492,212,157,374,686,843,1969,553,1151,290,818,592,592,386,833,462,162,125,476,660
butler,20,13,79.1,72.8,964,2041,694,1282,270,759,413,536,303,822,462,222,97,369,602,831,1846,572,1153,259,693,481,481,267,814,419,170,111,467,557
purdue,28,6,81.1,65.6,958,1928,632,1152,326,776,517,696,287,904,568,198,171,363,528,834,2033,598,1333,236,700,328,328,355,753,409,177,81,412,632
cal-state-fullerton,20,11,73.2,70.0,786,1671,623,1189,163,482,535,729,274,815,396,198,101,438,553,745,1802,534,1189,211,613,470,470,311,719,386,175,110,404,609
kansas,27,7,81.5,70.9,1024,2058,679,1201,345,857,378,539,325,872,578,225,142,397,519,886,2099,623,1294,263,805,375,375,405,790,431,191,121,442,571
pennsylvania,24,8,76.4,68.7,871,1893,591,1091,280,802,424,637,278,929,492,190,89,379,553,789,1909,604,1276,185,633,435,435,269,882,312,166,92,398,595
seton-hall,21,11,79.0,73.3,914,1950,681,1310,233,640,467,674,385,838,506,201,112,410,567,847,1940,605,1215,242,725,410,410,326,757,410,190,108,410,618
north-carolina-state,21,11,81.2,74.5,937,1993,685,1316,252,677,473,675,390,752,517,240,122,390,579,880,1894,688,1286,192,608,431,431,353,770,445,199,129,480,576
clemson,23,9,73.3,65.8,809,1786,543,1060,266,726,461,609,286,850,422,182,155,387,512,757,1845,515,1163,242,682,350,350,307,762,362,188,117,383,563
new-mexico-state,28,5,75.9,63.8,939,2042,690,1294,249,748,377,586,419,949,467,186,101,418,591,730,1860,514,1159,216,701,428,428,279,794,307,160,78,455,585
auburn,25,7,83.4,73.3,868,1977,556,1125,312,852,620,789,388,834,462,238,173,393,635,786,1849,528,1119,258,730,516,516,328,790,410,197,105,488,660
college-of-charleston,26,7,75.1,68.8,852,1854,598,1155,254,699,520,685,280,809,377,171,119,318,540,803,1848,569,1178,234,670,429,429,311,802,400,130,106,391,599
texas-christian,21,11,83.0,75.9,960,1925,689,1248,271,677,465,657,357,809,601,211,115,406,537,873,1900,614,1217,259,683,425,425,279,685,503,200,135,403,594
syracuse,21,13,67.3,64.3,771,1845,571,1224,200,621,547,745,408,862,372,244,185,425,554,743,1876,470,1046,273,830,427,427,354,765,553,213,108,435,625
michigan-state,29,4,81.0,64.8,943,1872,666,1201,277,671,509,678,365,983,638,135,243,435,596,736,2011,496,1291,240,720,426,426,358,642,403,199,81,329,655
bucknell,25,9,81.1,72.9,942,1995,673,1211,269,784,606,845,317,936,492,191,151,429,632,880,2080,661,1420,219,660,498,498,350,851,427,227,110,428,720
rhode-island,25,7,76.2,67.9,899,1957,681,1334,218,623,422,597,361,739,489,240,111,343,609,753,1671,585,1163,168,508,499,499,278,802,365,178,99,508,558
oklahoma,18,13,85.2,81.6,925,1993,629,1178,296,815,494,660,321,854,467,204,146,414,533,934,2100,652,1318,282,782,381,381,370,827,452,211,135,409,557
duke,26,7,84.7,69.6,1008,2044,734,1319,274,725,505,713,447,932,578,248,177,416,515,851,2121,601,1342,250,779,345,345,385,689,474,192,89,396,603
iona,20,13,79.8,76.2,931,2016,612,1194,319,822,452,612,282,835,526,224,101,385,571,933,2035,679,1320,254,715,393,393,366,875,481,167,92,452,565
virginia-tech,21,11,79.7,71.8,901,1811,621,1084,280,727,469,661,236,820,528,184,73,381,502,814,1915,530,1091,284,824,384,384,337,767,441,171,121,416,554